NO ./textures/brick_wall.xpm
SO ./textures/brick_wall.xpm
EA ./textures/wooden_floor_horizontal.xpm
WE ./textures/wooden_floor_horizontal.xpm

F 4,79,8
C 9,14,88



        1111111111111111111111111
        1000000000110000000000001
        1011000001110000000000001
        1001000000000000000000001
111111111011000001110000000000001
100000000011000001110111111111111
11110111111111011100000010001
11110111111111011101010010001
11000000110101011100000010001
10000000000000002200000020W01
10000000000000001101010010001
1100000111010101111101111000111
11110111 1110101 101111010001
11111111 1111111 111111111111